32 2 2 0 0 0 100 36
33 2 4 14 92 11 8 36
34 2 98 34 33 6 8 45
35 2 133 69 95 1 7 71
36 38 2 61 114 5 0 71
37 2 230 99 97 7 7 114
38 73 118 77 96 6 7 85
39 18 2 13 33 6 8 24
40 2 329 31 120 8 7 43
41 35 329 31 120 8 7 43
42 2 451 42 39 4 7 50
43 101 2 61 61 7 25 75
44 18 37 14 31 11 87 36
45 73 216 35 12 4 61 43
46 38 118 13 13 12 87 36
47 68 329 36 95 0 7 36
48 103 230 60 94 5 8 71
49 152 65 34 92 14 8 71
50 106 326 61 92 4 8 71
51 165 159 60 94 5 8 71
52 188 2 64 92 2 8 71
53 169 255 61 92 5 10 71
54 227 96 61 94 5 8 71
55 254 2 60 91 6 10 71
56 169 349 61 94 5 8 71
57 232 192 61 94 5 8 71
58 68 426 13 67 12 34 36
59 106 420 14 85 11 34 36
60 122 445 61 62 7 24 75
61 185 445 61 39 7 36 75
62 290 95 61 62 7 24 75
63 232 288 59 94 6 7 71
64 248 384 119 121 7 7 130
65 293 288 86 92 0 8 85
66 295 159 70 92 9 8 85
67 369 382 81 95 6 7 92
68 353 2 76 92 10 8 92
69 367 96 69 92 10 8 85
70 431 2 62 92 11 8 78
71 367 190 85 95 7 7 100
72 438 96 72 92 10 8 92
73 495 2 12 92 12 8 36
74 452 287 51 94 3 8 64
75 509 2 76 92 9 8 85
76 381 287 58 92 9 8 71
77 454 190 88 92 10 8 107
78 512 96 73 92 10 8 92
79 452 383 88 95 6 7 100
80 505 284 70 92 10 8 85
81 542 378 90 101 6 7 100
82 544 190 81 92 10 8 92
83 587 2 73 95 6 7 85
84 577 284 73 92 3 8 78
85 634 378 72 94 10 8 92
86 627 99 84 92 1 8 85
87 662 2 118 92 2 8 121
88 652 193 84 92 1 8 85
89 713 96 84 92 0 8 85
90 782 2 73 92 3 8 78
91 708 287 25 117 9 8 36
92 708 406 36 95 0 7 36
93 735 287 25 117 2 8 36
94 652 287 54 50 3 7 60
95 369 479 75 8 -2 117 71
96 2 492 24 18 6 8 43
97 738 190 61 70 5 32 71
98 746 406 58 93 8 8 71
99 799 96 58 70 5 32 64
100 762 262 58 93 4 8 71
101 857 2 62 70 5 32 71
102 806 357 39 94 1 7 36
103 822 168 59 95 4 32 71
104 859 74 54 92 8 8 71
105 801 168 12 92 9 8 28
106 847 265 26 119 -6 8 28
107 847 386 55 92 9 8 64
108 875 265 12 92 8 8 28
109 883 168 90 68 8 32 107
110 915 74 54 68 8 32 71
111 921 2 63 70 4 32 71
112 889 238 58 94 8 32 71
113 904 334 58 94 5 32 71
114 587 99 36 68 8 32 43
115 904 430 55 70 4 32 64
116 316 2 33 91 2 11 36
117 961 430 54 68 8 34 71
118 971 74 61 67 2 34 64
119 986 2 91 67 0 34 92
120 949 238 62 67 1 34 64
121 964 307 61 94 2 34 64
122 975 143 59 67 3 34 64
123 1027 212 37 120 4 7 43
124 1036 71 10 120 12 7 33
125 1048 71 37 120 3 7 43
126 369 489 64 21 5 45 75
32 0 0 0 0 5 45 36